# added postag entries
#-------------------------------------------------------------------------------
# Do not add words here, but report them to languagetool@taaltik.nl
#-------------------------------------------------------------------------------
aanbestedingsfases	aanbestedingsfase	ZNW:MRV:DE_
aardappelpart	aardappelpart	ZNW:EKV
aardappelparten	aardappelpart	ZNW:MRV:DE_
aardappelpartje	aardappelpart	ZNW:EKV:VRK:HET
aardappelpartjes	aardappelpart	ZNW:MRV:VRK:DE_
aardgasvrije	aardgasvrij	BNW:STL:VRB
adressen	adres	ZNW:MRV:DE_
allergeproportioneerdst	geproportioneerd	BNW:ALR:ONV
allergeproportioneerdste	geproportioneerd	BNW:ALR:VRB
allergeproportioneerdsten	geproportioneerd	BNW:ALR:MRV:DE_
anti-semitisch	anti-semitisch	BNW:STL:ONV
anti-semitische	anti-semitisch	BNW:STL:VRB
asfalteringswerkzaamheden	asfalteringswerkzaamheid	ZNW:MRV:DE_
asfalteringswerkzaamheid	asfalteringswerkzaamheid	ZNW:EKV:DE_
automatiseringsprojectje	automatiseringsproject	ZNW:EKV:VRK:HET
automatiseringsprojectjes	automatiseringsproject	ZNW:MRV:VRK:DE_
beiaardiers	beiaardier	ZNW:MRV:DE_
beoordelingssystematieken	beoordelingssystematiek	ZNW:MRV:DE_
bezettingstroepen	bezettingstroep	ZNW:MRV:DE_
binnenvaartschippers	binnenvaartschipper	ZNW:MRV:DE_
binnenvaartschippertje	binnenvaartschipper	ZNW:EKV:VRK:HET
binnenvaartschippertjes	binnenvaartschipper	ZNW:MRV:VRK:DE_
brandstofbesparende	brandstofbesparend	BNW:STL:VRB
charme-offensief	charme-offensief	ZNW:EKV:HET
charme-offensiefje	charme-offensief	ZNW:EKV:VRK:HET
charme-offensiefjes	charme-offensief	ZNW:MRV:VRK:DE_
charme-offensieven	charme-offensief	ZNW:MRV:DE_
communicatieadviesbureautjes	communicatieadviesbureau	ZNW:MRV:VRK:DE_
communicatiedoelstellinkje	communicatiedoelstelling	ZNW:EKV:VRK:HET
communicatiedoelstellinkjes	communicatiedoelstelling	ZNW:MRV:VRK:DE_
compressiekousje	compressiekous	ZNW:EKV:VRK:HET
consumptiemunten	consumptiemunt	ZNW:MRV:DE_
consumptiemuntje	consumptiemunt	ZNW:EKV:VRK:HET
consumptiemuntjes	consumptiemunt	ZNW:MRV:VRK:DE_
degradatiezorg	degradatiezorg	ZNW:EKV:DE_
degradatiezorgen	degradatiezorg	ZNW:MRV:DE_
degradatiezorgje	degradatiezorg	ZNW:EKV:VRK:HET
degradatiezorgjes	degradatiezorg	ZNW:MRV:VRK:DE_
drielaags	drielaags	BNW:STL:ONV
drielaagse	drielaags	BNW:STL:VRB
duizend	duizend	ZNW:EKV:HET
duizenden	duizend	ZNW:MRV:DE_
duurzaamheidsinitiatiefje	duurzaamheidsinitiatief	ZNW:EKV:VRK:HET
duurzaamheidsinitiatiefjes	duurzaamheidsinitiatief	ZNW:MRV:VRK:DE_
e-mail-adresje	e-mail-adres	ZNW:EKV:VRK:HET
e-mail-adresjes	e-mail-adres	ZNW:MRV:VRK:DE_
e-mail-adressen	e-mail-adres	ZNW:MRV:DE_
e-mailnieuwsbriefje	e-mailnieuwsbrief	ZNW:EKV:VRK:HET
e-mailnieuwsbriefjes	e-mailnieuwsbrief	ZNW:MRV:VRK:DE_
erbovenuit	erbovenuit	BYW
gasthoofdredacteurtje	gasthoofdredacteur	ZNW:EKV:VRK:HET
gasthoofdredacteurtjes	gasthoofdredacteur	ZNW:MRV:VRK:DE_
gastouderbureautje	gastouderbureau	ZNW:EKV:VRK:HET
geproportioneerden	geproportioneerd	BNW:STL:MRV:DE_
geproportioneerderen	geproportioneerd	BNW:VGR:MRV:DE_
geproportioneerdsten	geproportioneerd	BNW:OVR:MRV:DE_
gezondheidseis	gezondheidseis	ZNW:EKV:DE_
gezondheidswetenschappers	gezondheidswetenschapper	ZNW:MRV:DE_
gezondheidswetenschappertje	gezondheidswetenschapper	ZNW:EKV:VRK:HET
gezondheidswetenschappertjes	gezondheidswetenschapper	ZNW:MRV:VRK:DE_
gezonheidseisen	gezondheidseis	ZNW:MRV:DE_
gezonheidseisje	gezondheidseis	ZNW:EKV:VRK:HET
gezonheidseisjes	gezondheidseis	ZNW:MRV:VRK:DE_
groeibevorderende	groeibevorderend	BNW:STL:VRB
handenwassen	handenwassen	WKW:INF:ZNW:HET
hg	hg	MEH
honderd	honderd	ZNW:EKV:HET
honderden	honderd	ZNW:MRV:DE_
hoofdtelefoonaansluitinkje	hoofdtelefoonaansluiting	ZNW:EKV:VRK:HET
hoofdtelefoonaansluitinkjes	hoofdtelefoonaansluiting	ZNW:MRV:VRK:DE_
inbraakwerendheid	inbraakwerendheid	ZNW:EKV:DE_
investeringsuitgaven	investeringsuitgave	ZNW:MRV:DE_
kruisboogschieten	kruisboogschieten	WKW:INF:ZNW:HET
langebaanschaatsen	langebaanschaatsen	WKW:INF:ZNW:HET
lustopwekkend	lustopwekkend	BNW:STL:ONV
lustopwekkende	lustopwekkend	BNW:STL:VRB
mededingingsrechtelijke	mededingingsrechtelijk	BNW:STL:VRB
multifunctional	multifunctional	ZNW:EKV:DE_
niet-conventionele	niet-conventioneel	BNW:STL:VRB
niet-functionerende	niet-functionerend	BNW:STL:VRB
niet-georganiseerd	niet-georganiseerd	BNW:STL:ONV
niet-georganiseerde	niet-georganiseerd	BNW:STL:VRB
niet-noodzakelijk	niet-noodzakelijk	BNW:STL:ONV
niet-noodzakelijke	niet-noodzakelijk	BNW:STL:VRB
onderhoudsvriendelijkheden	onderhoudsvriendelijkheid	ZNW:MRV:DE_
onderhoudsvriendelijkheidje	onderhoudsvriendelijkheid	ZNW:EKV:VRK:HET
onderhoudsvriendelijkheidjes	onderhoudsvriendelijkheid	ZNW:MRV:VRK:DE_
ondernemingsrechtelijke	ondernemingsrechtelijk	BNW:STL:VRB
opengaand	opengaan	WKW:ODW:ONV
opengaande	opengaan	WKW:ODW:VRB
opengaanden	opengaan	WKW:ODW:MRV:DE_
opengegane	opengaan	WKW:VTD:VRB
oplosmiddelhoudende	oplosmiddelhoudend	BNW:STL:VRB
oranje-geel	oranje-geel	BNW:STL:ONV
oranje-gele	oranje-geel	BNW:STL:VRB
part	part	ZNW:EKV
partnerschapsvoorwaarden	partnerschapsvoorwaarde	ZNW:MRV:DE_
partnerschapsvoorwaardetje	partnerschapsvoorwaarde	ZNW:EKV:VRK:HET
partnerschapsvoorwaardetjes	partnerschapsvoorwaarde	ZNW:MRV:VRK:DE_
personeelsprobleempje	personeelsprobleem	ZNW:EKV:VRK:HET
personeelsprobleempjes	personeelsprobleem	ZNW:MRV:VRK:DE_
plantenetende	plantenetend	BNW:STL:VRB
polsstokhoogspringen	polsstokhoogspringen	WKW:INF:ZNW:HET
prijsopdrijvende	prijsopdrijvend	BNW:STL:VRB
privé-terreintjes	privé-terrein	ZNW:MRV:VRK:DE_
promotiedoeleindes	promotiedoeleinde	ZNW:MRV:DE_
promotiedoeleindje	promotiedoeleinde	ZNW:EKV:VRK:HET
promotiedoeleindjes	promotiedoeleinde	ZNW:MRV:VRK:DE_
randprogrammeringen	randprogrammering	ZNW:MRV:DE_
rechtsonderin	rechtsonderin	BYW
reinigingswerkzaamheden	reinigingswerkzaamheid	ZNW:MRV:DE_
reinigingswerkzaamheid	reinigingswerkzaamheid	ZNW:EKV:DE_
rijkbloeiend	rijkbloeiend	BNW:STL:ONV
rijkbloeiende	rijkbloeiend	BNW:STL:VRB
risicobeperkend	risicobeperkend	BNW:STL:ONV
risicobeperkende	risicobeperkend	BNW:STL:VRB
sectoroverstijgende	sectoroverstijgend	BNW:STL:VRB
student-assistentje	student-assistent	ZNW:EKV:VRK:HET
student-assistentjes	student-assistent	ZNW:MRV:VRK:DE_
studiedoeleinden	studiedoeleinde	ZNW:MRV:DE_
studiedoeleindes	studiedoeleinde	ZNW:MRV:DE_
studiedoeleindje	studiedoeleinde	ZNW:EKV:VRK:HET
studiedoeleindjes	studiedoeleinde	ZNW:MRV:VRK:DE_
studiekeuzechecks	studiekeuzecheck	ZNW:MRV:DE_
taalontwikkelingsstoornisje	taalontwikkelingsstoornis	ZNW:EKV:VRK:HET
taalontwikkelingsstoornisjes	taalontwikkelingsstoornis	ZNW:MRV:VRK:DE_
taalontwikkelingsstoornissen	taalontwikkelingsstoornis	ZNW:MRV:DE_
tegengestane	tegenstaan	WKW:VTD:VRB
tegengestane	tegenstaan	WKW:VTD:ZNW:EKV
tegengestanen	tegenstaan	WKW:VTD:ZNW:MRV:DE_
tegenstaand	tegenstaan	WKW:ODW:ONV
tegenstaande	tegenstaan	WKW:ODW:VRB
tegenstaanden	tegenstaan	WKW:ODW:MRV:DE_
tijdsomstandigheidje	tijdsomstandigheid	ZNW:EKV:VRK:HET
tijdsomstandigheidjes	tijdsomstandigheid	ZNW:MRV:VRK:DE_
toetredingsonderhandelingetje	toetredingsonderhandeling	ZNW:EKV:VRK:HET
toetredingsonderhandelingetjes	toetredingsonderhandeling	ZNW:MRV:VRK:DE_
uitgaven	uitgave	ZNW:MRV:DE_
uitvoeringsvoorschriftje	uitvoeringsvoorschrift	ZNW:EKV:VRK:HET
uitvoeringsvoorschriftjes	uitvoeringsvoorschrift	ZNW:MRV:VRK:DE_
vaccinatieboeken	vaccinatieboek	ZNW:MRV:DE_
vaccinatieboekje	vaccinatieboek	ZNW:EKV:VRK:HET
vaccinatieboekjes	vaccinatieboek	ZNW:MRV:VRK:DE_
vakbekwaamheidseis	vakbekwaamheidseis	ZNW:EKV:DE_
vakbekwaamheidseisen	vakbekwaamheidseis	ZNW:MRV:DE_
vakbekwaamheidseisje	vakbekwaamheidseis	ZNW:EKV:VRK:HET
vakbekwaamheidseisjes	vakbekwaamheidseis	ZNW:MRV:VRK:DE_
verbeteringswerken	verbeteringswerken	ZNW:EKV:HET
verbeteringswerkje	verbeteringswerken	ZNW:EKV:VRK:HET
verbeteringswerkjes	verbeteringswerken	ZNW:MRV:VRK:DE_
verbindingsprobleempjes	verbindingsprobleem	ZNW:MRV:VRK:DE_
verkavelingsplannen	verkavelingsplan	ZNW:MRV:DE_
verkavelingsplannetje	verkavelingsplan	ZNW:EKV:VRK:HET
verkavelingsplannetjes	verkavelingsplan	ZNW:MRV:VRK:DE_
verkavelingsplans	verkavelingsplan	ZNW:MRV:DE_
vernieuwingsprojectje	vernieuwingsproject	ZNW:EKV:VRK:HET
vernieuwingsprojectjes	vernieuwingsproject	ZNW:MRV:VRK:DE_
verwerkingsopdrachtjes	verwerkingsopdracht	ZNW:MRV:VRK:DE_
waarden	waarde	ZNW:MRV:DE_
waaromvraagje	waaromvraag	ZNW:EKV:VRK:HET
waaromvraagjes	waaromvraag	ZNW:MRV:VRK:DE_
welzijnsprobleempje	welzijnsprobleem	ZNW:EKV:VRK:HET
welzijnsprobleempjes	welzijnsprobleem	ZNW:MRV:VRK:DE_
werkgelegenheidsprojectje	werkgelegenheidsproject	ZNW:EKV:VRK:HET
werkgelegenheidsprojectjes	werkgelegenheidsproject	ZNW:MRV:VRK:DE_
wintersportplaatsen	wintersportplaatsen	ZNW:EKV:DE_
wintersportplaatsen	wintersportplaatsen	ZNW:MRV:DE_
wintersportplaatsje	wintersportplaatsen	ZNW:EKV:VRK:HET
wintersportplaatsjes	wintersportplaatsen	ZNW:MRV:VRK:DE_
zeileigenschap	zeileigenschap	ZNW:EKV:DE_
zeileigenschappen	zeileigenschap	ZNW:MRV:DE_
zorgzwaartepakketje	zorgzwaartepakket	ZNW:EKV:VRK:HET
zorgzwaartepakketjes	zorgzwaartepakket	ZNW:MRV:VRK:DE_
